R 1280 800
NO ./map/xpm/eagle.xpm
SO ./map/xpm/redbrick.xpm
WE ./map/xpm/colorstone.xpm
EA ./map/xpm/greystone.xpm

S ./map/xpm/barrel.xpm
F 64, 64, 64
C 0, 120, 255

11111111111111111111
10000001000100000001
10111000010000111111
10100011111100000001
10100100000100111001
10000001010100000001
10111111010111111001
1000000001N102000001
11111111111111111111
