R 640 480
NO ./xpm/bluestone.xpm
SO ./xpm/redbrick.xpm
WE ./xpm/colorstone.xpm
EA ./xpm/greystone.xpm

S ./xpm/pillar.xpm
F 220,110,0
C 225,30,0

 1111     11
100101   1001
1020011111001
 100N00000001
  1111111111
